{
    "groundTextureUrl": "./assets/textures/ground.jpg",
    "wallTextureUrl": "./assets/textures/wall.jpg",
    "doorTextureUrl": "./assets/textures/ground.jpg",
    "size": { "width": 10, "height": 10 },
    "map": [
        [3, 2, 2, 2, 3, 2, 2, 2, 2, 2, 1],
        [1, 0, 0, 0, 1, 0, 0, 0, 0, 0, 1],
        [1, 0, 0, 0, 1, 0, 0, 0, 0, 0, 1],
        [1, 0, 0, 0, 1, 0, 0, 0, 0, 0, 1],
        [3, 2, 0, 2, 0, 0, 0, 0, 0, 0, 1],
        [1, 0, 0, 0, 0, 0, 0, 0, 0, 0, 1],
        [1, 0, 0, 0, 0, 0, 0, 0, 0, 0, 1],
        [1, 0, 0, 0, 0, 0, 0, 0, 0, 0, 1],
        [1, 0, 0, 0, 0, 0, 0, 0, 0, 0, 1],
        [1, 0, 0, 0, 0, 0, 0, 0, 0, 0, 1],
        [2, 2, 2, 2, 2, 2, 2, 2, 2, 2, 0]
    ],
    "doorMap":[
        [0, 0, 0, 0, 0, 0, 0, 0, 0, 0, 0],
        [0, 0, 0, 0, 0, 0, 0, 0, 0, 0, 0],
        [0, 0, 0, 0, 0, 0, 0, 0, 0, 0, 0],
        [0, 0, 0, 0, 0, 0, 0, 0, 0, 0, 0],
        [0, 0, 1, 0, 0, 0, 0, 0, 0, 0, 0],
        [0, 0, 0, 0, 0, 0, 0, 0, 0, 0, 0],
        [0, 0, 0, 0, 0, 0, 0, 0, 0, 0, 0],
        [0, 0, 0, 0, 0, 0, 0, 0, 0, 0, 0],
        [0, 0, 0, 0, 0, 0, 0, 0, 0, 0, 0],
        [0, 0, 0, 0, 0, 0, 0, 0, 0, 0, 0],
        [0, 0, 0, 0, 0, 0, 0, 0, 0, 0, 0]
    ],
    "initialPosition": [4.5, 4.5],
    "initialDirection": 0.0
}