{
    "groundTextureUrl": "/textures/smoothwall.jpg",
    "wallTextureUrl": "/textures/wallteste.png",
    "size": { "width": 10, "height": 10 },
    "map": [
        [3, 2, 2, 2, 3, 2, 3, 2, 2, 2, 1],
        [1, 0, 0, 0, 1, 0, 1, 0, 0, 0, 1],
        [1, 0, 5, 0, 1, 0, 1, 0, 5, 0, 1],
        [1, 0, 0, 0, 1, 0, 1, 0, 0, 0, 1],
        [3, 2, 4, 2, 0, 0, 2, 4, 2, 2, 1],
        [1, 0, 0, 0, 0, 0, 0, 0, 0, 0, 1],
        [3, 2, 4, 2, 1, 0, 3, 4, 2, 2, 1],
        [1, 0, 0, 0, 1, 0, 1, 0, 0, 0, 1],
        [1, 0, 5, 0, 1, 0, 1, 0, 5, 0, 1],
        [1, 0, 0, 0, 1, 0, 1, 0, 0, 0, 1],
        [2, 2, 2, 2, 2, 2, 2, 2, 2, 2, 0]
    ],
    "doorMap":[
        [0, 0, 0, 0, 0, 0, 0, 0, 0, 0, 0],
        [0, 0, 0, 0, 0, 0, 0, 0, 0, 0, 0],
        [0, 0, 0, 0, 0, 0, 0, 0, 0, 0, 0],
        [0, 0, 0, 0, 0, 0, 0, 0, 0, 0, 0],
        [0, 0, 1, 0, 0, 0, 0, 1, 0, 0, 0],
        [0, 0, 0, 0, 0, 0, 0, 0, 0, 0, 0],
        [0, 0, 2, 0, 0, 0, 0, 2, 0, 0, 0],
        [0, 0, 0, 0, 0, 0, 0, 0, 0, 0, 0],
        [0, 0, 0, 0, 0, 0, 0, 0, 0, 0, 0],
        [0, 0, 0, 0, 0, 0, 0, 0, 0, 0, 0],
        [0, 0, 0, 0, 0, 0, 0, 0, 0, 0, 0]
    ],
    "tableMap":[
        [0, 0, 0, 0, 0, 0, 0, 0, 0, 0, 0],
        [0, 0, 0, 0, 0, 0, 0, 0, 0, 0, 0],
        [0, 0, 1, 0, 0, 0, 0, 0, 1, 0, 0],
        [0, 0, 0, 0, 0, 0, 0, 0, 0, 0, 0],
        [0, 0, 0, 0, 0, 0, 0, 0, 0, 0, 0],
        [0, 0, 0, 0, 0, 0, 0, 0, 0, 0, 0],
        [0, 0, 0, 0, 0, 0, 0, 0, 0, 0, 0],
        [0, 0, 0, 0, 0, 0, 0, 0, 0, 0, 0],
        [0, 0, 1, 0, 0, 0, 0, 0, 1, 0, 0],
        [0, 0, 0, 0, 0, 0, 0, 0, 0, 0, 0],
        [0, 0, 0, 0, 0, 0, 0, 0, 0, 0, 0]
    ],

    "appointments": [],

    "initialPosition": [4.5, 4.5],
    "initialDirection": 0.0,

    "rooms": [
        { "isOccupied": true },
        { "isOccupied": false },
        { "isOccupied": true },
        { "isOccupied": false }
    ]
}
